x,x,x,x,x,x,x,x,x,x
x,0,5,0,0,5,0,0,0,x
x,0,5,0,0,5,0,0,0,x
x,0,5,0,0,5,0,0,0,x
x,0,5,0,0,5,3,3,3,x
x,0,5,0,0,5,0,0,0,x
x,0,5,0,0,5,0,0,0,x
x,2,5,0,0,5,0,0,0,x
x,0,5,0,0,5,0,0,0,x
x,x,x,x,x,x,x,x,x,x
