x,x,x,x,x,x,x,x,x,x
x,0,0,0,x,B,0,0,x,x
x,0,x,0,x,x,0,0,0,x
x,0,0,0,0,0,0,1,0,x
x,0,x,3,x,x,0,1,3,x
x,0,x,8,x,0,0,x,0,x
x,0,x,0,x,x,0,0,0,x
x,0,x,3,x,x,0,1,3,x
x,0,0,0,x,B,0,0,x,x
x,x,x,x,x,x,x,x,x,x
